GG  GGGg
GG  GGGg
GGGGGGGg
GGGGGGGg
GGGGGGGGGGGGGGGGGGGGGg
GGGGGGGGGGGGGGGGGGGGGg
GGGGGGGGGGGGGGGGGGGGGg
     GGGGGGGGGGGGGGGGg
     GGGGGGGGGGGGGGGGg
     GGGGGGGGGGGGGGGGg
     GGGGGGGGGGGGGGGGg
     GGGGGGGGGGGGGGGGg
     GGGGGGGGGGGGGGGGg
     GGGGGGGGGGGGGGGGg
     GGGGGGGGGGGGGGGGg
GGGGGGGGGGGGGGGGGGGGGg
GGGGGGGGGGGGGGGGGGGGGg
GGGGGGGGGGGGGGGGGG
GGGGGGGGGGGGGGGGG
GGGGGGGGGGGGGGGG
GGGGGGGGGGGGGG
GGGGGGGGGGGG
GGGGGGGg
SSSSSGGg
SSSSSGGg
SSSSSGGg
SSSSSGGg
SSSSSGGg
SSSSSGGg
SSSSSGGg
SSSSSGGg
SSSSSGGg
SSSSSGGg
SSSSSGGg
SSSSSGGg
SSSSSGGg
SSSSSGGg
SSSSSGGg
SSSSSGGg
SSSSSGGg
SSSSSGGg
SSSSSGGg
SSSSSGGg
SSSSSGGg
SSSSSGGg
GGGGGGGg
GGGGGGGg
GGGGGGGg
GGGGGGGg
GGGGGGg
GGGGGg
GGGGg
GGGg
GGGGGg
GGGGGg
GGGGGGGg
GGGGGGGg
GGGGGGGg
GGGGGGGg
GGGGGGGg
SSSSSSGg
SSSSSSGg
SSSSSSGg
SSSSSSGg
SSSSSSGg
SSSSSSGg
GGGGGGGg
GGGGGGGg
GGGGGGGg
GGGGGGGg
GGGGGGGg
GGGGGGGg
GGGGGGGg
GGGGGGGg
GGGGGGGg
GGGGGGGg
GGGGGGGg
GGGGGGGg
GGGGGGGg
GGGGGGGg
GGGGGGGg
GGGGGGGg
GGGGGGGg
GGGGGGGg
GGGGGGGg
GGGGGGGg
GGGGGGGg
GGGGGGGg
GGGGGGGg
GGGGGGGg
GGGGGGGg
GGGGGGGg
GGGGGGGg
GGGGGGGg
GGGGGGGg
GGGGGGGg
GGGGGGGg
GGGGGGGg
GGGGGGGg
GGGGGGGg
GGGGGGGg
GGGGGGGg
GGGGGGGg
GGGGGGGg
GGGGGGGg
GGGGGGGg
GGGGGGGg
GGGGGGGg
GGGGGGGg
GGGGGGGg
GGGGGGGg
GGGGGGGg
GGGGGGGg
GGGGGGGg
GGGGGGGg
GGGGGGGg
GGGGGGGg
GGGGGGGg
GGGGGGGg